"Date","Type","Check #","Description","Withdrawal (-)","Deposit (+)","RunningBalance"
"Posted Transactions"
"07/22/2016","ATM","","ATM-0035 Pc Luis de Cam Lisboa","$44.24","","$3.59"
"07/18/2016","ATM","","ATM-0033 C C Mouraria Lisboa","$44.60","","$47.83"
"07/16/2016","ATM","","ATM-0035 Pc Carlos Albe Porto","$78.05","","$92.43"
"07/12/2016","ATM","","ATM-0035 Pc Carlos Albe Porto","$55.38","","$170.48"
"07/08/2016","ATM","","ATM-0018 Acoreana - R C PORTO","$55.57","","$225.86"
"07/04/2016","ATM","","ATM-0035 Pc Carlos Albe Porto","$89.36","","$281.43"
"06/30/2016","INTADJUST","","Interest Paid","","$0.01","$370.79"